--------------------------------------------------
|              k             k                   |
|                       f                       k|
|                            f             k k   |
|    k     f                                     |
|       f               f                        |
|      f                                         |
|                                                |
|                                       f        |
|  ff                                            |
|                                  f            k|
|                                                |
|      k                                 k       |
|     f                f  f        f             |
|                                             f  |
|                          f            k        |
|                                   f            |
|           f          f        fk           f   |
|                                                |
--------------------------------------------------
