--------------------------------------------------
|       f                               f        |
|                               k                |
|      f    k                         k f        |
|  f                                             |
| f               k   f                          |
| f                                              |
|         f              f          k  fk        |
|           k                       k            |
|                                                |
|                                                |
|                                   f   f        |
|                               f                |
|                                              f |
|                           k           k        |
|                                               f|
|        k   f                                   |
|                                           k    |
|      f    k               f   k  f    f        |
|              f                                 |
|                                           k    |
|                           k                    |
|                                         f   f  |
|        f                                     f |
|f      k                                        |
|                f         f                     |
|            k              f                    |
|       f          k                k          f |
|                  f                             |
|           k  f                k             k  |
|     k                              k           |
|  k        k    f                         f    f|
|                k                               |
|                                     f          |
|                          f                     |
|                   k                  k   f k   |
|                                               k|
|                                                |
|       f       k                                |
|           k                                 f  |
|   k                     k                k     |
|                            f                   |
|     k                                          |
|           k                            f       |
|                                                |
|                             k              k   |
|       f          k         k      k    k       |
|                                                |
|  f        k            f           k  k      f |
--------------------------------------------------
