--------------------------------------------------
| f                                           k  |
|               k                                |
|    f               f       k                   |
|                      f             k   k k     |
|k                 f f           k      k        |
|                                            f   |
|                       f     f              f   |
|            k                     f             |
|    f      f                      k             |
|                                      k         |
|                                                |
|           f  f      k                          |
|              f       f                      k  |
|                                       f    f   |
|   k                             f          k   |
|                           f                    |
|       ff          f                       f    |
|         f               k            f         |
|                                                |
|              f                                 |
|        k                                       |
|                                                |
|f                                    k          |
|fk             f            f                   |
|                                      k         |
|                                                |
|            k                                   |
|k                   f                           |
|                               f                |
|    k                                           |
|                    k               k          f|
|                          f    k                |
|                    k             f             |
|                                                |
|                                            f   |
|       f                                f       |
|                                                |
|  k                                             |
|                                               f|
|     k   k                       k              |
|            f                                   |
|          k  k         f         f  f           |
|                                                |
|                                             f  |
| k        k    k                                |
|                   k  k                         |
|                                 k              |
|           k  k f                               |
--------------------------------------------------
