----------
|        |
|        |
|   f    |
| f k    |
|x  k    |
| ff  k  |
|  f f   |
| f      |
----------
