----------
|    k   |
|   k  k |
| f     f|
|  k     |
|x       |
|      f |
|   f   f|
| kk     |
----------
