----------
| f  k f |
|ff      |
|f   k   |
|  f k  k|
|     kf |
|       f|
|k   f   |
|        |
----------
