----------
|  k   k |
| k      |
|kf  fk  |
|        |
|f     f |
|  f     |
|        |
|f       |
----------
